NO ./textures/Murakami.xpm
SO ./textures/SO.xpm
WE ./textures/Pikachu.xpm
EA ./textures/Ceribou.xpm
F 253, 233, 224
C 3, 34, 76

111111111111111
100000000000001
101010101010101
100000000000001
101010101010101
100000000000001
101010101010101
100000000000001
101010101010101
100000000000001
101010101010101
100000000000001
1010101N1010101
100000000000001
101010101010101
100000000000001
101010101010101
100000000000001
111111111111111
