NO ./textures/Univers.xpm
SO ./textures/Univers.xpm
WE ./textures/Univers.xpm
EA ./textures/Galaxy_red.xpm

F 0, 0, 51
C 0,0,51

        1111111111111111111111111
        1000000000110000000000001
        1000000000110010000100001
        10110000011100000000000W1
        1001000000000001001000001
111111111011000001110000000000001
100000000011000001110111111111111
11110111111111011100000010001
11110111111111011101010010001
11000000110101011100000010001
10000000000000001100000010001
10000000000000001101010010001
1100000111010101111101111000111
11110111 1110101 101111010001 
11111111 1111111 111111111111
